
F 69, 51, 49
C 199, 204, 145


NO ./textures/Texture Metallic11670948645.xpm
SO ./textures/Texture Metallic21670948646.xpm
EA ./textures/Texture Metallic31670948646.xpm
WE ./textures/Texture Metallic41670948646.xpm

1111111111111111111111111111111111111111111111111111111
11N1010101010101010101010101010101010101010101010101011
1000111100000000000000000000000000000000000000000000111
1100111100000000000000000000000000000000000000000000101
1000111100111111111111111111111111111111111111111100111
1100111100111000000000000000000000000000000000011100101
1000111100111000000000000000000000000000000000011100111
1100111100111001111111111111111111111111111110011100101
1000111100111001111000000000000000000000011110011100111
1100111100111001111000000000000000000000011110011100101
1000111100111001111001000000000000000010011110011100111
1100111100111001111001000001110000000010011110011100101
1000111100111001111001000001110000000010011110011100111
1100111100111001111001000001110000000010011110011100101
1000111100111001111001000000000000000010011110011100111
1100111100111001111001000011000000000010011110011100101
1000111100111001111000000011000000000110011110011100111
1100111100111001111111111111111111111110011110011100101
1000111100111000000000000000000000000000011110011100111
1100111100111000000000000000000000000000011110011100101
1000111100111111111111111111111111111111111110011100111
1100111100000000000000000000000000000000000000011100101
1000111100000000000000000000000000000000000000011100111
1100111111111111111111111111111111111111111111111100101
1000000000000000000000000000000000000000000000000001111
1101010101010101010101010101010101010101010101010101011
1111111111111111111111111111111111111111111111111111111
