
F 69, 51, 49
C 186, 164, 25



NO ./textures/Texture Metallic11670948645.xpm
SO ./textures/Texture Metallic21670948646.xpm
EA ./textures/Texture Metallic31670948646.xpm
WE ./textures/Texture Metallic41670948646.xpm

1111111111111111111111111
10000000000110000000000001
101100N00001110000000000001
110010000000000000000000000111111111
111111111011000001110000000000001
100000000011000001110111111111111
11110111111111011100000010001
11110111111111011101010010001
11000000110101011100000010001
10000000000000001100000010001
1000000000000001101010010001
11000001110101011111011110001
1111111111010110111101000111
111111111111111111111111111
