
F 100,200,0
C 0,0,255 

NO ./textures/n.xpm
SO ./textures/s.xpm
WE ./textures/w.xpm
EA ./textures/e.xpm


1111111111111111111111111
1000000000110000000000001
1011000001110000000000001
110010000000000000000000111111111
111111111011000001110000000000001
100000000011000001110111111111111
11110111111111011100000010001
11110111111111011101010010001
11000000110101011100000010001
10000000000000001100000010001
10000000000000001101010000001
11000001110101011111011110N01
11110111111010110111101000111
111111111111111111111111111
