NO ./path_to_the_north_texture
SO ./path_to_the_south_texture
WE ./path_to_the_west_texture
EA ./path_to_the_east_texture

F 220,100,0
C 225,30,0

1111111111111111111111111
1000000000110000000000001
1011000001110000000000001
1001000000000000000000001
1111111110110000011100001
1000000000110000011101111
1111011111111101110000001
11110111111111011101010111111
110000001101010111000000000001
100000000000000011000000000001
100000000000N00011010101111111
1100000111010101111101111
1111011111101011011110101
1111111111111111111111111
